Coming Home
An Interactive Fiction by Geraldo
Release 1 / Serial number 210130 / Inform 7 build 6M62 (I6/v6.33 lib 6/12N) SD

Kitchen
You can see a Large Wooden Door, a Strong Metal Door, Parrot, Fridge, Lower Cupboard , Kitchen table and Upper Cupboard (closed) here.

>n
(first opening Main door)
It seems to be locked.

>n
Living Room

>s
Hall

* * *

>n
(first opening Main door)
It seems to be locked.

>up
Upper Hall
You can see Stairs here.

* * *

>n
(first opening Main door)
It seems to be locked.

>unlock Main door
What do you want to unlock Main door with?

* * *

>n
(first opening Main door)
It seems to be locked.

I beg your pardon?

I beg your pardon?

* * *

Coming Home
An Interactive Fiction by Geraldo
Release 1 / Serial number 210130 / Inform 7 build 6M62 (I6/v6.33 lib 6/12N) SD

Kitchen
You can see a Large Wooden Door, a Strong Metal Door, Parrot, Fridge, Lower Cupboard , Kitchen table and Upper Cupboard (closed) here.

>look
Garage
This garage feels a little... dirty.

>up
You can't go that way.

>n
Hall
You can see Stairs here.

>look
Hall
You can see Stairs here.

>n
Living Room

>s
Hall
You can see Stairs here.

>s
Porch
You can see You here.

>n
Hall
You can see Stairs here.

>e
Lavabo

>w
Hall
You can see Stairs here.

>up
Upper Hall
You can see Stairs here.

>down
Hall
You can see Stairs here.

>climb stairs
Upper Hall
You can see Stairs here.

>climb stairs
Hall
You can see Stairs here.

>stairs
That's not a verb I recognise.

>enter Living Room
You can't see any such thing.

>enter staris
You can't see any such thing.

>enter stairs
Upper Hall
You can see Stairs here.

* * *

>look
Garage
This garage feels a little... dirty.

>examine motorcycle
You can't see any such thing.

* * *

Coming Home
An Interactive Fiction by Geraldo
Release 1 / Serial number 210130 / Inform 7 build 6M62 (I6/v6.33 lib 6/12N) SD

Kitchen
You can see a Large Wooden Door, a Strong Metal Door, Parrot, Fridge, Lower Cupboard , Kitchen table and Upper Cupboard (closed) here.

>get key
A chill runs up your spine
Taken.

>unlock door
(with Main key)
You unlock Main door.

>n
(first opening Main door)

Hall
You can see Main door here.

>up
Upper Hall

>down
Hall
You can see Main door here.

* * *

>unlock door
(with Main key)
You unlock Main door.

>enter door
(first opening Main door)

Hall
You can see Main door here.

>n
Living Room
You can see Body, Child, Paiting and Shelves (on which is trophies) here.

>n
Dining Room

>w
Kitchen

>w
You can't go that way.

>e
Dining Room

>s
Living Room

>w
Garage

>examine motorcycle
You can't see any such thing.

* * *

>n
Living Room
You can see Body, Child, Paiting and Shelves (on which is trophies) here.

>w
Garage
This garage feels a little... dirty. No one has been here for a while for sure.

You can see Motorcycle (on which is sticker) and Toolbox (in which is screwdriver) here.

>look
Garage

* * *

>w
Garage
This garage feels a little... dirty. No one has been here for a while for sure.

You can see Motorcycle (on which is sticker) and Toolbox (in which is screwdriver) here.

>examine motorcycle
This old rusty motorbike… It's a delivery one. Maybe he was a pizza guy too… back in the 1800"s HA. I've been thinking of quitting. Every other day there's a "situation" with the other pizza place. These mafias...

On Motorcycle is sticker.

>touch motorcycle
Woah, this thing is FILTHY. Oh, there is a broken heart sticker here. He does seem like he was lonely.

>examine sticker
I guess if I quit, I'll never see Joe's son, Ethan, again. I've had… strong feelings for him for a while now . Well, it's better this way. He would never EVER like me back. Besides, being into guys is kinda weird.

* * *

>unlock door
(with Main key)
You unlock Main door.

>enter
You get onto Wooden chair.

>enter door
You can't sit in a occupied chair

>get up
You get off Wooden chair.

Porch
You can see Main door, Wooden chair, Old box (in which are candle and string) and bucket (empty) here.

>enter door
(first opening Main door)

Hall
You can see Main door here.

>n
Living Room

>w
Garage
This garage feels a little... dirty.

You can see Motorcycle (on which is Sticker) here.

>examine motorcycle
This old rusty motorbike… It's a delivery one. Maybe he was a pizza guy too… back in the 1800"s HA. I've been thinking of quitting. Every other day there's a "situation" with the other pizza place. These mafias...

On Motorcycle is Sticker.

>touch
(Main key)
You feel nothing unexpected.

>touch motorcycle
Wow, this thing is FILTHY. Oh, there is a broken heart sticker here. He does seem like he was lonely.

You feel nothing unexpected.

>examine sticker
I guess if I quit, I'll never see Joe's son, Ethan, again. I've had… strong feelings for him for a while now . Well, it's better this way. He would never EVER like me back. Besides, being into guys is kinda weird.

* * *

>get key
A chill runs up your spine
Taken.

>unlock door with key
You unlock Main door.

>enter
You get onto Wooden chair.

>out
You get off Wooden chair.

Porch
You can see Main door, Wooden chair, Old box (in which are candle and string) and bucket (empty) here.

>n
(first opening Main door)

Hall
You can see Main door here.

>close door
You close Main door.

>scenes
Scene 'Entire Game' playing (for 6 mins now)
Scene 'Being Outside the House' ended
(Scene monitoring now switched on. Type "scenes off" to switch it off again.)

* * *

>get key
A chill runs up your spine
Taken.

>open box
It isn't something you can open.

>examine box
In Old box are candle and string.

>get
What do you want to get?

>get candle and string
candle: Taken.
string: Taken.

>get bucket
Taken.

>examine
What do you want to examine?

>porch
You can't see any such thing.

>open door
It seems to be locked.

>use key
That's not a verb I recognise.

>unlock door
What do you want to unlock Main door with?

>key
You unlock Main door.

>open door
You open Main door.

>examine door
You see nothing special about Main door.

>enter
You get onto Wooden chair.

>leave
You get off Wooden chair.

Porch
You can see Main door, Wooden chair and Old box (empty) here.

>open door
That's already open.

>enter door
Hall
You can see Main door here.

>map
That's not a verb I recognise.

>n
Living Room

>n
Dining Room

>n
You can't go that way.

>s
Living Room

>e
Home Office

I beg your pardon?

>e
You can't go that way.

>w
Living Room

>w
Garage

>examine
What do you want to examine?

>examine garage
You can't see any such thing.

* * *

>get key
A chill runs up your spine
Taken.

>open door
It seems to be locked.

>enter door
(first opening Main door)
It seems to be locked.

>unlock door
(with Main key)
You unlock Main door.

* * *

>enter door
(first opening Main door)

Hall
You can see Main door here.

>n
Living Room
You can see Body here.

>touch body
I better not touch it. Don't wanna tamper with evidence.

>get body
I don't want to carry a dead body with me, what would Jesus think?

>examine body
It looks like an old guy. I don't see any wounds or blood to indicate a murder or fight. Maybe he died naturally? He sure is old enough for that. He seems oddly sad for someone who is no longer living. I have to call the police

>w
Garage
This garage feels a little... dirty.

You can see Motorcycle (on which is sticker) and Toolbox (in which is screwdriver) here.

* * *

Coming Home
An Interactive Fiction by Geraldo
Release 1 / Serial number 210130 / Inform 7 build 6M62 (I6/v6.33 lib 6/12N) SD

Kitchen
You can see a Large Wooden Door, a Strong Metal Door, Parrot, Fridge, Lower Cupboard , Kitchen table and Upper Cupboard (closed) here.

>sit
What do you want to sit on?

>sit on wooden chair
You cant sit in it

* * *

Coming Home
An Interactive Fiction by Geraldo
Release 1 / Serial number 210130 / Inform 7 build 6M62 (I6/v6.33 lib 6/12N) SD

Kitchen
You can see a Large Wooden Door, a Strong Metal Door, Parrot, Fridge, Lower Cupboard , Kitchen table and Upper Cupboard (closed) here.

>sit on chair
You feel confortable

>look chair
You see nothing special about Wooden chair.

>get wooden chair
That's fixed in place.

>enter chair
That's not something you can enter.

* * *

>sit on chair
You feel confortable

>look
Porch (on Wooden chair)
You can see Main door, Main key and You here.

* * *

>sit on chair
You feel confortable

>up
(first getting off Wooden chair)
You can't go that way.

* * *

>sit on chair
You feel confortable

>out
You get off Wooden chair.

Porch
You can see Main door, Main key, You, Wooden chair, Old box (empty), thing1, thing2 and thing3 here.

>get thing1
Taken.

>put thing1 on chair
You put thing1 on Wooden chair.

>sit on chair
You can't sit in the Wooden chair, it is occupied

* * *

>look
Porch
You can see Main door, Main key, You, Wooden chair (on which is thing1), Old box (empty), thing2 and thing3 here.

I beg your pardon?

>out
But you aren't in anything at the moment.

>look
Porch
You can see Main door, Main key, You, Wooden chair (on which is thing1), Old box (empty), thing2 and thing3 here.

* * *

Coming Home
An Interactive Fiction by Geraldo
Release 1 / Serial number 210130 / Inform 7 build 6M62 (I6/v6.33 lib 6/12N) SD

Kitchen
You can see a Large Wooden Door, a Strong Metal Door, Parrot, Fridge, Lower Cupboard , Kitchen table and Upper Cupboard (closed) here.

>enter chair
You get onto Wooden chair.

>out
You get off Wooden chair.

Porch
You can see Main door, Main key, You and Wooden chair here.

>sit on chair
You cant sit in it

>is chair seatable?
That's not a verb I recognise.

>help
That's not a verb I recognise.

* * *

Coming Home
An Interactive Fiction by Geraldo
Release 1 / Serial number 210130 / Inform 7 build 6M62 (I6/v6.33 lib 6/12N) SD

Kitchen
You can see a Large Wooden Door, a Strong Metal Door, Parrot, Fridge, Lower Cupboard , Kitchen table and Upper Cupboard (closed) here.

>test me
>--> No test scripts exist for this game.

* * *

Coming Home
An Interactive Fiction by Geraldo
Release 1 / Serial number 210130 / Inform 7 build 6M62 (I6/v6.33 lib 6/12N) SD

Kitchen
You can see a Large Wooden Door, a Strong Metal Door, Parrot, Fridge, Lower Cupboard , Kitchen table and Upper Cupboard (closed) here.

>sit on box
You can't sit on Old box

>look
Porch
You can see Main door, Main key, You, Wooden chair and Old box (empty) here.

>enter bpx
You can't see any such thing.

>enter box
That's not something you can enter.

* * *

>sit on box
You can't sit on Old box

>sit on chair
You can't sit on Wooden chair
You feel confortable

* * *

>sit on box
You can't sit on Old box

>get box
Taken.

>put box on chair
You put Old box on Wooden chair.

>sit chair
I didn't understand that sentence.

>sit on chair
You can't sit in a occupied chair

>get box
Taken.

>sit on chair
You feel confortable

* * *

>look
Porch (on Wooden chair)
You can see Main door, Main key and You here.

>get key
A chill runs up your spine
Taken.

* * *

>sit on box
You can't sit on Old box

>enter box
That's not something you can enter.

>enter chair
You get onto Wooden chair.

>look
Porch (on Wooden chair)
You can see Main door, Main key, You, Old box (empty), thing1, thing2 and thing3 here.

>get all
Main key: A chill runs up your spine
Taken.
You: Taken.
Old box: Taken.
thing1: Taken.
thing2: Taken.
thing3: Taken.

>i
You are carrying:
  thing3
  thing2
  thing1
  Old box
  You
  Main key

>drop me
You lack the dexterity.

>drop all
thing3: There is no more room on Wooden chair.
thing2: There is no more room on Wooden chair.
thing1: There is no more room on Wooden chair.
Old box: There is no more room on Wooden chair.
You: There is no more room on Wooden chair.
Main key: There is no more room on Wooden chair.

>exit
You get off Wooden chair.

Porch
You can see Main door and Wooden chair here.

>drop all
thing3: Dropped.
thing2: Dropped.
thing1: Dropped.
Old box: Dropped.
You: Dropped.
Main key: Dropped.

>get me
You are always self-possessed.

>i
You are carrying nothing.

>get all
Main key: A chill runs up your spine
Taken.
You: Taken.
Old box: Taken.
thing1: Taken.
thing2: Taken.
thing3: Taken.

* * *

>i
You are carrying:
  thing3
  thing2
  thing1
  Old box
  You
  Main key

>actions
Actions listing on.

>rules
Rules tracing now switched on. Type "rules off" to switch it off again, or "rules all" to include even rules which do not apply.

>actions off
Actions listing off.

>rules off
Rules tracing now switched off. Type "rules" to switch it on again.

>drop all
thing3: Dropped.
thing2: Dropped.
thing1: Dropped.
Old box: Dropped.
You: Dropped.
Main key: Dropped.

>get all
Main key: A chill runs up your spine
Taken.
You: Taken.
Old box: Taken.
thing1: Taken.
thing2: Taken.
thing3: Taken.

* * *

Coming Home
An Interactive Fiction by Geraldo
Release 1 / Serial number 210130 / Inform 7 build 6M62 (I6/v6.33 lib 6/12N) SD

Kitchen
You can see a Large Wooden Door, a Strong Metal Door, Parrot, Fridge, Lower Cupboard , Kitchen table and Upper Cupboard (closed) here.

>get box
Taken.

* * *

>sit chair
I didn't understand that sentence.

>sit on chair
You cant sit in a occupied chair

* * *

Coming Home
An Interactive Fiction by Geraldo
Release 1 / Serial number 210130 / Inform 7 build 6M62 (I6/v6.33 lib 6/12N) SD

Kitchen
You can see a Large Wooden Door, a Strong Metal Door, Parrot, Fridge, Lower Cupboard , Kitchen table and Upper Cupboard (closed) here.

>examine motorcycle
This old rusty motorbike… It's a delivery one. Maybe he was a pizza guy too… back in the 1800"s HA. I've been thinking of quitting. Every other day there's a "situation" with the other pizza place. These mafias...

On Motorcycle is sticker.

>touch motorcycle
Wow, this thing is FILTHY. Oh, there is a broken heart sticker here. He does seem like he was lonely.

You feel nothing unexpected.

>examine sticker
I guess I'll never see Joe's son, Ethan, again. I've had… strong feelings for him for a while now . Well, it's better this way. He would never EVER like me back. Besides, being into guys is kinda weird.

* * *

>examine motorcycle
This old rusty motorbike… It's a delivery one. Maybe he was a pizza guy too… back in the 1800"s HA. I've been thinking of quitting. Every other day there's a "situation" with the other pizza place. These mafias...

On Motorcycle is sticker.

>examine broken heart sticker
Woah, this thing is FILTHY. Oh, there is a broken heart sticker here. He does seem like he was lonely.

I guess if I quit, I'll never see Joe's son, Ethan, again. I've had… strong feelings for him for a while now . Well, it's better this way. He would never EVER like me back. Besides, being into guys is kinda weird.

* * *

>examine motorcycle
This old rusty motorbike… It's a delivery one. Maybe he was a pizza guy too… back in the 1800"s HA. I've been thinking of quitting. Every other day there's a "situation" with the other pizza place. These mafias...

On Motorcycle is sticker.

>examine sticker
Woah, this thing is FILTHY. Oh, there is a broken heart sticker here. He does seem like he was lonely.

I guess if I quit, I'll never see Joe's son, Ethan, again. I've had… strong feelings for him for a while now . Well, it's better this way. He would never EVER like me back. Besides, being into guys is kinda weird.

* * *

Coming Home
An Interactive Fiction by Geraldo
Release 1 / Serial number 210130 / Inform 7 build 6M62 (I6/v6.33 lib 6/12N) SD

Kitchen
You can see a Large Wooden Door, a Strong Metal Door, Parrot, Fridge, Lower Cupboard , Kitchen table and Upper Cupboard (closed) here.

>examine sticker
I guess I'll never see Joe's son, Ethan, again. I've had… strong feelings for him for a while now . Well, it's better this way.

>examine motorcycle
This old rusty motorbike… It's a delivery one. Maybe he was a pizza guy too… back in the 1800"s HA. I've been thinking of quitting. Every other day there's a "situation" with the other pizza place. These mafias...

On Motorcycle is Sticker.

* * *

Coming Home
An Interactive Fiction by Geraldo
Release 1 / Serial number 210130 / Inform 7 build 6M62 (I6/v6.33 lib 6/12N) SD

Kitchen
You can see a Large Wooden Door, a Strong Metal Door, Parrot, Fridge, Lower Cupboard , Kitchen table and Upper Cupboard (closed) here.

>touch
(Motorcycle)
You feel nothing unexpected.

>examine
(Motorcycle)
This old rusty motorbike… It's a delivery one. Maybe he was a pizza guy too… back in the 1800"s HA. I've been thinking of quitting. Every other day there's a "situation" with the other pizza place. These mafias...

On Motorcycle is Sticker.

>examine
(Motorcycle)
This old rusty motorbike… It's a delivery one. Maybe he was a pizza guy too… back in the 1800"s HA. I've been thinking of quitting. Every other day there's a "situation" with the other pizza place. These mafias...

On Motorcycle is Sticker.

>examine sticker
I guess I'll never see Joe's son, Ethan, again. I've had… strong feelings for him for a while now . Well, it's better this way. He would never EVER like me back. Besides, being into guys is kinda weird.

* * *

Coming Home
An Interactive Fiction by Geraldo
Release 1 / Serial number 210130 / Inform 7 build 6M62 (I6/v6.33 lib 6/12N) SD

Kitchen
You can see a Large Wooden Door, a Strong Metal Door, Parrot, Fridge, Lower Cupboard , Kitchen table and Upper Cupboard (closed) here.

>examine
(Motorcycle)
This old rusty motorbike… It's a delivery one. Maybe he was a pizza guy too… back in the 1800"s HA. I've been thinking of quitting. Every other day there's a "situation" with the other pizza place. These mafias...

On Motorcycle is Sticker.

>touch motorcycle
A chill runs up your spine
You feel nothing unexpected.

* * *

>examine
(Motorcycle)
This old rusty motorbike… It's a delivery one. Maybe he was a pizza guy too… back in the 1800"s HA. I've been thinking of quitting. Every other day there's a "situation" with the other pizza place. These mafias...

On Motorcycle is Sticker.

>touch motorcycle
Wow, this thing is FILTHY. Oh, there is a broken heart sticker here. He does seem like he was lonely.

You feel nothing unexpected.

>get motorcycle
That's fixed in place.

>examine sticker
I guess if I quit, I'll never see Joe's son, Ethan, again. I've had… strong feelings for him for a while now . Well, it's better this way. He would never EVER like me back. Besides, being into guys is kinda weird.

>get sticker
Taken.

>drop sticker
Dropped.

* * *

Coming Home
An Interactive Fiction by Geraldo
Release 1 / Serial number 210130 / Inform 7 build 6M62 (I6/v6.33 lib 6/12N) SD

Kitchen
You can see a Large Wooden Door, a Strong Metal Door, Parrot, Fridge, Lower Cupboard , Kitchen table and Upper Cupboard (closed) here.

>examine toolbov
You can't see any such thing.

>examine toolbox
Your usual toolbox.

In Toolbox is screwdriver.

>get screwdriver
Taken.

>examine
(screwdriver)
You see nothing special about screwdriver.

>examine motorcycle
This old rusty motorbike… It's a delivery one. Maybe he was a pizza guy too… back in the 1800"s HA. I've been thinking of quitting. Every other day there's a "situation" with the other pizza place. These mafias...

On Motorcycle is broken heart sticker.

* * *

Coming Home
An Interactive Fiction by Geraldo
Release 1 / Serial number 210130 / Inform 7 build 6M62 (I6/v6.33 lib 6/12N) SD

Kitchen
You can see a Large Wooden Door, a Strong Metal Door, Parrot, Fridge, Lower Cupboard , Kitchen table and Upper Cupboard (closed) here.

>touch body
I better not touch it. Don't wanna tamper with evidence.

>examine body
It looks like an old guy. I don't see any wounds or blood to indicate a murder or fight. Maybe he died naturally? He sure is old enough for that. He seems oddly sad for someone who is no longer living. I have to call the police

* * *

Coming Home
An Interactive Fiction by Geraldo
Release 1 / Serial number 210130 / Inform 7 build 6M62 (I6/v6.33 lib 6/12N) SD

Kitchen
You can see a Large Wooden Door, a Strong Metal Door, Parrot, Fridge, Lower Cupboard , Kitchen table and Upper Cupboard (closed) here.

>get body
I don't want to carry a dead body with me, what would Jesus think?

>touch body
I better not touch it. Don't wanna tamper with evidence.

* * *

Coming Home
An Interactive Fiction by Geraldo
Release 1 / Serial number 210130 / Inform 7 build 6M62 (I6/v6.33 lib 6/12N) SD

Kitchen
You can see a Large Wooden Door, a Strong Metal Door, Parrot, Fridge, Lower Cupboard , Kitchen table and Upper Cupboard (closed) here.

>look w
You see nothing unexpected in that direction.

>look s
You see nothing unexpected in that direction.

>look u
You see nothing unexpected in that direction.

>look e
You see nothing unexpected in that direction.

>walk w
You can't go that way.

>walk e
You can't go that way.

>walk s
You can't go that way.

>open door
It seems to be locked.

>get main kei
Which do you mean, Main door or Main key?

>main key
I only understood you as far as wanting to get Main key.

>get main key
A chill runs up your spine
Taken.

>open main door
It seems to be locked.

>unlocked door
That's not a verb I recognise.

>unlock door
(with Main key)
You unlock Main door.

* * *

>look s
You see nothing unexpected in that direction.

>examine s
You see nothing unexpected in that direction.

>examine w
You see nothing unexpected in that direction.

>examine l
You can't see any such thing.

>walk w
(first opening the Solid metal door)
It seems to be locked.

>walk s
Hall
You can see Main door here.

>up
Upper Hall
You can see an Old Blue Door, a Classical Door and a Brown Weak Door here.

>down
Hall
You can see Main door here.

>walk w
You can't go that way.

>walk s
(first opening Main door)
It seems to be locked.

>walk s
(first opening Main door)
It seems to be locked.

>walk e
Lavabo

>walk w
Hall
You can see Main door here.

>walk n
Living Room
You can see a Solid metal door, Body, Child, Paiting, Shelves and Bookshelf here.

>child, look under Bookshelf
Oh the child found a key. It must open something here. I'll keep it. Thank you k.. oh and you are back at the table. You're a really strange kid.

>walk n
Dining room
You can see a Large Wooden Door here.

>unlock Large Wooden Door
(with Silver key)
You unlock the Large Wooden Door.

>walk n
You can't go that way.

>walk w
(first opening the Large Wooden Door)

Kitchen
You can see a Large Wooden Door, a Strong Metal Door, Fridge, Lower Cupboard , Kitchen table and Upper Cupboard (closed) here.

>examine table
On Kitchen table are garage key, pizza and mail.

>get garage key
Taken.

>unlock Strong Metal Door
What do you want to unlock the Strong Metal Door with?

>garage key
You unlock the Strong Metal Door.

>walk n
You can't go that way.

>walk e
Dining room
You can see a Large Wooden Door here.

>walk w
Kitchen
You can see a Large Wooden Door, a Strong Metal Door, Fridge, Lower Cupboard , Kitchen table and Upper Cupboard (closed) here.

>walk w
You can't go that way.

>walk s
(first opening the Strong Metal Door)

Garage
This garage feels a little... dirty. No one has been here for a while for sure.

You can see a Strong Metal Door, a Solid metal door, Motorcycle and Toolbox here.

>examine toolbox
Your usual toolbox.

In Toolbox are crowbar and screwdriver.

>take crowbar
Taken.

>walk w
You can't go that way.

>walk s
You can't go that way.

>walk e
(first opening the Solid metal door)
It seems to be locked.

>unlock
What do you want to unlock?

>garage key
What do you want to unlock garage key with?

>Strong Metal Door
(first taking the Strong Metal Door)
That's fixed in place.

>walk e
(first opening the Solid metal door)
It seems to be locked.

>unlock Solid metal door
What do you want to unlock the Solid metal door with?

>garage key
You unlock the Solid metal door.

>walk e
(first opening the Solid metal door)

Living Room
You can see a Solid metal door, Body, Child, Paiting, Shelves and Bookshelf here.

>walk s
Hall
You can see Main door here.

* * *

>up
Upper Hall
You can see an Old Blue Door, a Classical Door and a Brown Weak Door here.

>unlock bworn weak
You can't see any such thing.

>unlock brown
What do you want to unlock the Brown Weak Door with?

>crowbar
You unlock the Brown Weak Door.

>walk n
(first opening the Classical Door)
It seems to be locked.

>walk s
(first opening the Brown Weak Door)

Bathroom
This place gives me the chills… I was never a fan of bathrooms

You can see a Brown Weak Door, Mirror and Bathroom Cupboard  here.

>examine Bathroom Cupboard
A regular bathroom cabinet. Nothing special about its exterior.

In Bathroom Cupboard  are hair pins, q-tip, tweezers, meds and alcohol.

>get hair pins
Taken.

>walk n
Upper Hall
You can see a Brown Weak Door, an Old Blue Door and a Classical Door here.

>unlock classical
What do you want to unlock the Classical Door with?

>hair pins
You unlock the Classical Door.

>walk w
Small Bedroom

>walk e
Upper Hall
You can see a Brown Weak Door, an Old Blue Door and a Classical Door here.

>walk e
(first opening the Old Blue Door)
It seems to be locked.

>walk s
Bathroom
This place gives me the chills… I was never a fan of bathrooms

You can see a Brown Weak Door, Mirror and Bathroom Cupboard  here.

>walk n
Upper Hall
You can see a Brown Weak Door, an Old Blue Door and a Classical Door here.

>walk n
(first opening the Classical Door)

Large Bedroom
You can see a Classical Door, Personal box, Clothes rack , Bedside table, Photo shelves and Wardrobe here.

>examine personal box
Box with a space decoration and filled with drawings, papers and toys about… space, apparently. That's pretty sweet, actually. I wonder if it belongs to a grandson (though he seems to not have any family). I always liked the idea of studying the unknown. I will study it someday actually… I think. When things are more stable, f-for sure I will… I just need more time… Err... the kid! The kid likes space. I could tell him about this box, it may distract him from the gloominess

In Personal box is secret compartment.

>unlock secret compartment
What do you want to unlock secret compartment with?

>tweezers
You can't see any such thing.

* * *

Coming Home
An Interactive Fiction by Geraldo
Release 1 / Serial number 210130 / Inform 7 build 6M62 (I6/v6.33 lib 6/12N) SD

Kitchen
You can see a Large Wooden Door, a Strong Metal Door, Parrot, Fridge, Lower Cupboard , Kitchen table and Upper Cupboard (closed) here.

>get main key
A chill runs up your spine
Taken.

>unlock main door
(with Main key)
You unlock Main door.

>walk n
(first opening Main door)

Hall
You can see Main door here.

>walk n
Living Room
You can see 'Garage door', Body, Child, Paiting and Shelves (on which is trophies) here.

>walk w
(first opening 'Garage door')
It seems to be locked.

* * *

Coming Home
An Interactive Fiction by Geraldo
Release 1 / Serial number 210130 / Inform 7 build 6M62 (I6/v6.33 lib 6/12N) SD

Kitchen
You can see a Large Wooden Door, a Strong Metal Door, Parrot, Fridge, Lower Cupboard , Kitchen table and Upper Cupboard (closed) here.

>walk w
(first opening 'Garage door')
It seems to be locked.

>unlock Garage door
You can't see any such thing.

>open garage door
You can't see any such thing.

* * *

Coming Home
An Interactive Fiction by Geraldo
Release 1 / Serial number 210130 / Inform 7 build 6M62 (I6/v6.33 lib 6/12N) SD

Kitchen
You can see a Large Wooden Door, a Strong Metal Door, Parrot, Fridge, Lower Cupboard , Kitchen table and Upper Cupboard (closed) here.

>open main door
It seems to be locked.

* * *

Coming Home
An Interactive Fiction by Geraldo
Release 1 / Serial number 210130 / Inform 7 build 6M62 (I6/v6.33 lib 6/12N) SD

Kitchen
You can see a Large Wooden Door, a Strong Metal Door, Parrot, Fridge, Lower Cupboard , Kitchen table and Upper Cupboard (closed) here.

>open garage door
You can't see any such thing.

* * *

Coming Home
An Interactive Fiction by Geraldo
Release 1 / Serial number 210130 / Inform 7 build 6M62 (I6/v6.33 lib 6/12N) SD

Kitchen
You can see a Large Wooden Door, a Strong Metal Door, Parrot, Fridge, Lower Cupboard , Kitchen table and Upper Cupboard (closed) here.

>open blue door
It seems to be locked.

* * *

Coming Home
An Interactive Fiction by Geraldo
Release 1 / Serial number 210130 / Inform 7 build 6M62 (I6/v6.33 lib 6/12N) SD

Kitchen
You can see a Large Wooden Door, a Strong Metal Door, Parrot, Fridge, Lower Cupboard , Kitchen table and Upper Cupboard (closed) here.

>open solid metal door
It seems to be locked.

>break solid metal door
Violence isn't the answer to this one.

>unlock solid metal door
What do you want to unlock the Solid metal door with?

>main key
You can't see any such thing.

* * *

Coming Home
An Interactive Fiction by Geraldo
Release 1 / Serial number 210130 / Inform 7 build 6M62 (I6/v6.33 lib 6/12N) SD

Kitchen
You can see a Large Wooden Door, a Strong Metal Door, Parrot, Fridge, Lower Cupboard , Kitchen table and Upper Cupboard (closed) here.

>take garage key
Taken.

>take 'garage key'
Taken.

>w s
I only understood you as far as wanting to (go) w.

>walk s
Garage
This garage feels a little... dirty. No one has been here for a while for sure.

You can see a Solid metal door, Motorcycle (on which is sticker) and Toolbox (in which is screwdriver) here.

* * *

>take garage key
Taken.

>strong metal door
That's not a verb I recognise.

* * *

>unlock Strong Metal Door with garage key
You unlock the Strong Metal Door.

* * *

Coming Home
An Interactive Fiction by Geraldo
Release 1 / Serial number 210130 / Inform 7 build 6M62 (I6/v6.33 lib 6/12N) SD

Kitchen
You can see a Large Wooden Door, a Strong Metal Door, Parrot, Fridge, Lower Cupboard , Kitchen table and Upper Cupboard (closed) here.

>open strong metal door
It seems to be locked.

>get 'garage key'
Taken.

>open strong metal door
It seems to be locked.

>unlock strong metal door
(with 'garage key')
That doesn't seem to fit the lock.

* * *

>open strong metal door
It seems to be locked.

>unlock  strong
What do you want to unlock the Strong Metal Door with?

>main key
You can't see any such thing.

>get garage key
Taken.

>unlock strong
(with garage key)
That doesn't seem to fit the lock.

* * *

Coming Home
An Interactive Fiction by Geraldo
Release 1 / Serial number 210130 / Inform 7 build 6M62 (I6/v6.33 lib 6/12N) SD

Kitchen
You can see a Large Wooden Door, a Strong Metal Door, Parrot, Fridge, Lower Cupboard , Kitchen table and Upper Cupboard (closed) here.

>unlock strong metal door
What do you want to unlock the Strong metal door with?

>garage key
(first taking garage key)
You unlock the Strong metal door.

* * *

Coming Home
An Interactive Fiction by Geraldo
Release 1 / Serial number 210130 / Inform 7 build 6M62 (I6/v6.33 lib 6/12N) SD

Kitchen
You can see a Large Wooden Door, a Strong Metal Door, Parrot, Fridge, Lower Cupboard , Kitchen table and Upper Cupboard (closed) here.

>open strong
It seems to be locked.

>open door
It seems to be locked.

>get garage key
Taken.

>open door
It seems to be locked.

>open strong
It seems to be locked.

>unlock door
(with garage key)
You unlock the Strong Metal Door.

>open door
You open the Strong Metal Door.

>w south
I only understood you as far as wanting to (go) w.

>walk south
Garage
This garage feels a little... dirty. No one has been here for a while for sure.

You can see a Strong Metal Door, a Solid metal door, Motorcycle (on which is sticker) and Toolbox (in which is screwdriver) here.

* * *

Coming Home
An Interactive Fiction by Geraldo
Release 1 / Serial number 210130 / Inform 7 build 6M62 (I6/v6.33 lib 6/12N) SD

Kitchen
You can see a Large Wooden Door, a Strong Metal Door, Parrot, Fridge, Lower Cupboard , Kitchen table and Upper Cupboard (closed) here.

>look shelves
In Shelves is trophies.

>search shelves
In Shelves is trophies.

* * *

Coming Home
An Interactive Fiction by Geraldo
Release 1 / Serial number 210130 / Inform 7 build 6M62 (I6/v6.33 lib 6/12N) SD

Kitchen
You can see a Large Wooden Door, a Strong Metal Door, Parrot, Fridge, Lower Cupboard , Kitchen table and Upper Cupboard (closed) here.

>search shelves
In Shelves is trophies.

>look under shelves
Billy's lost marble! So that's where it got to!

>take silver key
You already have that.

* * *

Coming Home
An Interactive Fiction by Geraldo
Release 1 / Serial number 210130 / Inform 7 build 6M62 (I6/v6.33 lib 6/12N) SD

Kitchen
You can see a Large Wooden Door, a Strong Metal Door, Parrot, Fridge, Lower Cupboard , Kitchen table and Upper Cupboard (closed) here.

>examine Bookshelf
That's a lot of books, but they are incredibly dusty. Safe to say our guy didn't have allergies. Quite a bunch about physics too, he must have worked with that, neat! Hmm, it looks like there's something underneath it, but the crack is too small

>look under Bookshelf
oh it's a key. IIt must open something here

* * *

>examine Bookshelf
That's a lot of books, but they are incredibly dusty. Safe to say our guy didn't have allergies. Quite a bunch about physics too, he must have worked with that, neat! Hmm, it looks like there's something underneath it, but the crack is too small

>child, look under Bookshelf
Oh the child found a key. It must open something here. I'll keep it. Thank you kid

* * *

Coming Home
An Interactive Fiction by Geraldo
Release 1 / Serial number 210130 / Inform 7 build 6M62 (I6/v6.33 lib 6/12N) SD

Kitchen
You can see a Large Wooden Door, a Strong Metal Door, Parrot, Fridge, Lower Cupboard , Kitchen table and Upper Cupboard (closed) here.

>examine Shelves
On Shelves is trophies.

>search Shelves
It looks like some trophies from science fairs and contests… But they only go up to High School level. I wonder what happened after that.

I beg your pardon?

>examine bookshelf
That's a lot of books, but they are incredibly dusty. Safe to say our guy didn't have allergies. Quite a bunch about physics too, he must have worked with that, neat! Hmm, it looks like there's something underneath it, but the crack is too small

>look under bookshelf
Oh it's a key. It must open something here.

* * *

>examine Shelves
On Shelves is trophies.

>take trophies
I am not going to steal some old awards, I have my own at home… Somewhere

>get trophies
You can't see any such thing.

* * *

>take trophies
I am not going to steal some old awards, I have my own at home… Somewhere

>open shelves
It isn't something you can open.

>examine shelves
You see nothing special about Shelves.

>get throphies
You can't see any such thing.

* * *

>take trophies
I am not going to steal some old awards, I have my own at home… Somewhere

>examine shelves
You see nothing special about Shelves.

* * *

>take trophies
I am not going to steal some old awards, I have my own at home… Somewhere

>walk s
Hall
You can see Main door here.

>walk n
Living Room
You can see trophies, a Solid metal door, Body, Child, Paiting, Shelves and Bookshelf here.

* * *

>examine Shelves
On Shelves is trophies.

>examine trophies
It looks like some trophies from science fairs and contests… But they only go up to High School level. I wonder what happened after that.

>trophies
That's not a verb I recognise.

* * *

>examine trophies
It looks like some trophies from science fairs and contests… But they only go up to High School level. I wonder what happened after that.

>take trophies
I am not going to steal some old awards, I have my own at home… Somewhere.

>examine Bookshelf
That's a lot of books, but they are incredibly dusty. Safe to say our guy didn't have allergies. Quite a bunch about physics too, he must have worked with that, neat! Hmm, it looks like there's something underneath it, but the crack is too small

>look under Bookshelf
Oh it's a key. It must open something here.

>open Solid metal door
It seems to be locked.

>order clhild look under bookshelf
That's not a verb I recognise.

>child look under bookshelf
That's not a verb I recognise.

>look under bookshelf
You find nothing of interest.

>child, look under bookshelf
Child has better things to do.

* * *

>examine trophies
It looks like some trophies from science fairs and contests… But they only go up to High School level. I wonder what happened after that.

>get trophies
I am not going to steal some old awards, I have my own at home… Somewhere.

>examine bookshelf
That's a lot of books, but they are incredibly dusty. Safe to say our guy didn't have allergies. Quite a bunch about physics too, he must have worked with that, neat! Hmm, it looks like there's something underneath it, but the crack is too small

>child, look under Bookshelf
Oh the child found a key. It must open something here. I'll keep it. Thank you k.. oh and you are back at the table. You're a really strange kid.

>unlock Solid metal door
(with Silver key)
That doesn't seem to fit the lock.

>walk north
Dining room
You can see a Large Wooden Door here.

>unlock Dining room
You can't see any such thing.

>unlock Large Wooden Door
(with Silver key)
You unlock the Large Wooden Door.

>Walk west
(first opening the Large Wooden Door)

Kitchen
You can see a Large Wooden Door, a Strong Metal Door, Fridge (empty), Lower Cupboard (in which is candy), Upper Cupboard (closed) and Kitchen table (on which are garage key, pizza and mail) here.

* * *

Coming Home
An Interactive Fiction by Geraldo
Release 1 / Serial number 210130 / Inform 7 build 6M62 (I6/v6.33 lib 6/12N) SD

Kitchen
You can see a Large Wooden Door, a Strong Metal Door, Parrot, Fridge, Lower Cupboard , Kitchen table and Upper Cupboard (closed) here.

>examine shelves
It looks like some trophies from science fairs and contests… But they only go up to High School level. I wonder what happened after that.

>get trophies
You can't see any such thing.

>take trophies
You can't see any such thing.

* * *

>examine shelves
It looks like some trophies from science fairs and contests… But they only go up to High School level. I wonder what happened after that.

>get trhophies
You can't see any such thing.

* * *

>examine shelves
It looks like some trophies from science fairs and contests… But they only go up to High School level. I wonder what happened after that.

>take trophies
You can't see any such thing.

>get trophies
You can't see any such thing.

>take throphies
You can't see any such thing.

* * *

>take trophies
You can't see any such thing.

>take throphies
Taken.

* * *

>examine shelves
It looks like some trophies from science fairs and contests… But they only go up to High School level. I wonder what happened after that.

>examine shelves
You see nothing special about Shelves.

>take trophies
You can't see any such thing.

* * *

>get trophies
You can't see any such thing.

>open shelves
It isn't something you can open.

* * *

>examine shelves
It looks like some trophies from science fairs and contests… But they only go up to High School level. I wonder what happened after that.

>walk n
Dining Room

>walk
You'll have to say which compass direction to go in.

>walk s
Living Room
You can see a Solid metal door, Body, Child, Paiting, Shelves and Bookshelf here.

>examine shelves
You see nothing special about Shelves.

* * *

Coming Home
An Interactive Fiction by Geraldo
Release 1 / Serial number 210130 / Inform 7 build 6M62 (I6/v6.33 lib 6/12N) SD

Kitchen
You can see a Large Wooden Door, a Strong Metal Door, Parrot, Fridge, Lower Cupboard , Kitchen table and Upper Cupboard (closed) here.

>examine sheves
You can't see any such thing.

>examine shelves
It looks like some trophies from science fairs and contests… But they only go up to High School level. I wonder what happened after that.

* * *

>take trophies
You can't see any such thing.

>living room
That's not a verb I recognise.

>look around
You can't see any such thing.

>look room
You can't see any such thing.

>walk s
Hall
You can see Main door here.

>walk n
Living Room
You can see a Solid metal door, Body, Child, Paiting, Shelves and Bookshelf here.

* * *

Coming Home
An Interactive Fiction by Geraldo
Release 1 / Serial number 210130 / Inform 7 build 6M62 (I6/v6.33 lib 6/12N) SD

Kitchen
You can see a Large Wooden Door, a Strong Metal Door, Parrot, Fridge, Lower Cupboard , Kitchen table and Upper Cupboard (closed) here.

>examine trhophies
You can't see any such thing.

>take trophies
You can't see any such thing.

>examine shelves
It looks like some trophies from science fairs and contests… But they only go up to High School level. I wonder what happened after that.

* * *

Coming Home
An Interactive Fiction by Geraldo
Release 1 / Serial number 210130 / Inform 7 build 6M62 (I6/v6.33 lib 6/12N) SD

Kitchen
You can see a Large Wooden Door, a Strong Metal Door, Parrot, Fridge, Lower Cupboard , Kitchen table and Upper Cupboard (closed) here.

>look under shelves
There seems to be a banana under the table.

>take banana
Taken.

* * *

Coming Home
An Interactive Fiction by Geraldo
Release 1 / Serial number 210130 / Inform 7 build 6M62 (I6/v6.33 lib 6/12N) SD

Kitchen
You can see a Large Wooden Door, a Strong Metal Door, Parrot, Fridge, Lower Cupboard , Kitchen table and Upper Cupboard (closed) here.

>examine sh
You can't see any such thing.

>exaine shelves
That's not a verb I recognise.

>examine shelves
It looks like some trophies from science fairs and contests… But they only go up to High School level. I wonder what happened after that.

>tak trophies
That's not a verb I recognise.

>take trophies
You can't see any such thing.

* * *

Coming Home
An Interactive Fiction by Geraldo
Release 1 / Serial number 210130 / Inform 7 build 6M62 (I6/v6.33 lib 6/12N) SD

Kitchen
You can see a Large Wooden Door, a Strong Metal Door, Parrot, Fridge, Lower Cupboard , Kitchen table and Upper Cupboard (closed) here.

>ask child to look under Bookshelf
I didn't understand that sentence.

>asking child to try looking under Bookshelf
That's not a verb I recognise.

>child, look under Bookshelf
Oh it's a key. It must open something here. I'll keep it.

* * *

Coming Home
An Interactive Fiction by Geraldo
Release 1 / Serial number 210130 / Inform 7 build 6M62 (I6/v6.33 lib 6/12N) SD

Kitchen
You can see a Large Wooden Door, a Strong Metal Door, Parrot, Fridge, Lower Cupboard , Kitchen table and Upper Cupboard (closed) here.

>look bookshelf
That's a lot of books, but they are incredibly dusty. Safe to say our guy didn't have allergies. Quite a bunch about physics too, he must have worked with that, neat! Hmm, it looks like there's something underneath it, but the crack is too small

>child, look under bookshelf
Oh the child found a key. It must open something here. I'll keep it. Thank you k.. oh and you are back at the table. You're a really strange kid.

* * *

Coming Home
An Interactive Fiction by Geraldo
Release 1 / Serial number 210130 / Inform 7 build 6M62 (I6/v6.33 lib 6/12N) SD

Kitchen
You can see a Large Wooden Door, a Strong Metal Door, Parrot, Fridge, Lower Cupboard , Kitchen table and Upper Cupboard (closed) here.

>child, look under Bookshelf
Oh the child found a key. It must open something here. I'll keep it. Thank you k.. oh and you are back at the table. You're a really strange kid.

* * *

>walk n
Dining room
You can see a Large Wooden Door here.

>open  Large Wooden Door
It seems to be locked.

>unlock Large Wooden Door
(with Silver key)
You unlock the Large Wooden Door.

* * *

>walk n
You can't go that way.

>walk east
You can't go that way.

>walk west
(first opening the Large Wooden Door)

Kitchen
You can see a Large Wooden Door, a Strong Metal Door, Fridge (empty), Lower Cupboard (in which is candy), Upper Cupboard (closed) and Kitchen table (on which are garage key, pizza and mail) here.

* * *

Coming Home
An Interactive Fiction by Geraldo
Release 1 / Serial number 210130 / Inform 7 build 6M62 (I6/v6.33 lib 6/12N) SD

Kitchen
You can see a Large Wooden Door, a Strong Metal Door, Parrot, Fridge, Lower Cupboard , Kitchen table and Upper Cupboard (closed) here.

>open Fridge
The fridge is quite empty, must be why he ordered pizza. There is only a pack of eggs and a pistachio ice cream in the freezer. Man, I love pistachio ice cream.

>take pistachio ice cream
I better not steal food from the old guy, I'm thinking this would count against me when I die.

>take eggs
I better not steal food from the old guy, I'm thinking this would count against me when I die.

>open Upper Cupboard with crowbar
(first taking crowbar)
That doesn't seem to fit the lock.

>take crowbar
You already have that.

>open Upper Cupboard
I would potentially destroy his entire cabinet, better I get rid of the crowbar and only use a smaller tool.

It seems to be locked.

* * *

Coming Home
An Interactive Fiction by Geraldo
Release 1 / Serial number 210130 / Inform 7 build 6M62 (I6/v6.33 lib 6/12N) SD

Kitchen
You can see a Large Wooden Door, a Strong Metal Door, Parrot, Fridge, Lower Cupboard , Kitchen table and Upper Cupboard (closed) here.

>open fridge
The fridge is quite empty, must be why he ordered pizza. There is only a pack of eggs and a pistachio ice cream in the freezer. Man, I love pistachio ice cream.

>take eggs
I better not steal food from the old guy, I'm thinking this would count against me when I die.

>examine lower
Apparently our man had a sweet tooth. Look at all this candy, his dentist must hate him… Must have hated him...

In Lower Cupboard is candy.

* * *

Coming Home
An Interactive Fiction by Geraldo
Release 1 / Serial number 210130 / Inform 7 build 6M62 (I6/v6.33 lib 6/12N) SD

Kitchen
You can see a Large Wooden Door, a Strong Metal Door, Parrot, Fridge, Lower Cupboard , Kitchen table and Upper Cupboard (closed) here.

>open Lower Cupboard
Apparently our man had a sweet tooth. Look at all this candy, his dentist must hate him… Must have hated him...

>get candy
I don't have health insurance, better not surrender myself to the temptations of potential cavities yet… Maybe when I'm older.

* * *

Coming Home
An Interactive Fiction by Geraldo
Release 1 / Serial number 210130 / Inform 7 build 6M62 (I6/v6.33 lib 6/12N) SD

Kitchen
You can see a Large Wooden Door, a Strong Metal Door, Parrot, Fridge, Lower Cupboard , Kitchen table and Upper Cupboard (closed) here.

>take crowbar
Taken.

>open  Upper Cupboard
I would potentially destroy his entire cabinet, better I get rid of the crowbar and only use a smaller tool
It seems to be locked.

* * *

>take crowbar
Taken.

>unlock Upper Cupboard
(with crowbar)
I would potentially destroy his entire cabinet, better use a smaller tool

* * *

Coming Home
An Interactive Fiction by Geraldo
Release 1 / Serial number 210130 / Inform 7 build 6M62 (I6/v6.33 lib 6/12N) SD

Kitchen
You can see a Large Wooden Door, a Strong Metal Door, Parrot, Fridge, Lower Cupboard , Kitchen table and Upper Cupboard (closed) here.

>open  Upper Cupboard
It isn't something you can open.

>open Upper Cupboard with crowbar
(first taking crowbar)
That doesn't seem to be something you can unlock.

* * *

Coming Home
An Interactive Fiction by Geraldo
Release 1 / Serial number 210130 / Inform 7 build 6M62 (I6/v6.33 lib 6/12N) SD

Kitchen
You can see a Large Wooden Door, a Strong Metal Door, Parrot, Fridge, Lower Cupboard , Kitchen table and Upper Cupboard (closed) here.

>open Upper Cupboard with crowbar
(first taking crowbar)
That doesn't seem to fit the lock.

>open  Upper Cupboard
It isn't something you can open.

* * *

Coming Home
An Interactive Fiction by Geraldo
Release 1 / Serial number 210130 / Inform 7 build 6M62 (I6/v6.33 lib 6/12N) SD

Kitchen
You can see a Large Wooden Door, a Strong Metal Door, Parrot, Fridge, Lower Cupboard , Kitchen table and Upper Cupboard (closed) here.

>Instead of opening a Upper Cupboard when the noun is a crowbar:
That's not a verb I recognise.

>open Upper Cupboard with crowbar
(first taking crowbar)
That doesn't seem to be something you can unlock.

>open  Upper Cupboard (
I only understood you as far as wanting to open Upper Cupboard.

>open Upper Cupboard
It isn't something you can open.

* * *

Coming Home
An Interactive Fiction by Geraldo
Release 1 / Serial number 210130 / Inform 7 build 6M62 (I6/v6.33 lib 6/12N) SD

Kitchen
You can see a Large Wooden Door, a Strong Metal Door, Parrot, Fridge, Lower Cupboard , Kitchen table and Upper Cupboard (closed) here.

>open Upper Cupboard
It isn't something you can open.

* * *

Coming Home
An Interactive Fiction by Geraldo
Release 1 / Serial number 210130 / Inform 7 build 6M62 (I6/v6.33 lib 6/12N) SD

Kitchen
You can see a Large Wooden Door, a Strong Metal Door, Parrot, Fridge, Lower Cupboard , Kitchen table and Upper Cupboard (closed) here.

>open upper
The fridge is quite empty, must be why he ordered pizza. There is only a pack of eggs and a pistachio ice cream in the freezer. Man, I love pistachio ice cream.

* * *

Coming Home
An Interactive Fiction by Geraldo
Release 1 / Serial number 210130 / Inform 7 build 6M62 (I6/v6.33 lib 6/12N) SD

Kitchen
You can see a Large Wooden Door, a Strong Metal Door, Parrot, Fridge, Lower Cupboard , Kitchen table and Upper Cupboard (closed) here.

>open upper with crowbar
(first taking crowbar)
That doesn't seem to fit the lock.

* * *

Coming Home
An Interactive Fiction by Geraldo
Release 1 / Serial number 210130 / Inform 7 build 6M62 (I6/v6.33 lib 6/12N) SD

Kitchen
You can see a Large Wooden Door, a Strong Metal Door, Parrot, Fridge, Lower Cupboard , Kitchen table and Upper Cupboard (closed) here.

>unlocking the Upper Cupboard with crowbar
I would potentially destroy his entire cabinet, better use a smaller tool

* * *

Coming Home
An Interactive Fiction by Geraldo
Release 1 / Serial number 210130 / Inform 7 build 6M62 (I6/v6.33 lib 6/12N) SD

Kitchen
You can see a Large Wooden Door, a Strong Metal Door, Parrot, Fridge, Lower Cupboard , Kitchen table and Upper Cupboard (closed) here.

>unlock the Upper Cupboard with crowbar
(first taking crowbar)
That doesn't seem to fit the lock.

* * *

Coming Home
An Interactive Fiction by Geraldo
Release 1 / Serial number 210130 / Inform 7 build 6M62 (I6/v6.33 lib 6/12N) SD

Kitchen
You can see a Large Wooden Door, a Strong Metal Door, Parrot, Fridge, Lower Cupboard , Kitchen table and Upper Cupboard (closed) here.

>unlock Upper Cupboard with crowbar
(first taking crowbar)
I would potentially destroy his entire cabinet, better use a smaller tool

>unlock Upper Cupboard with screwdriver
(first taking screwdriver)
You unlock Upper Cupboard.

* * *

Coming Home
An Interactive Fiction by Geraldo
Release 1 / Serial number 210130 / Inform 7 build 6M62 (I6/v6.33 lib 6/12N) SD

Kitchen
You can see a Large Wooden Door, a Strong Metal Door, Parrot, Fridge, Lower Cupboard , Kitchen table and Upper Cupboard (closed) here.

>open the Upper Cupboard with crowbar
(first taking crowbar)
That doesn't seem to fit the lock.

* * *

Coming Home
An Interactive Fiction by Geraldo
Release 1 / Serial number 210130 / Inform 7 build 6M62 (I6/v6.33 lib 6/12N) SD

Kitchen
You can see a Large Wooden Door, a Strong Metal Door, Parrot, Fridge, Lower Cupboard , Kitchen table and Upper Cupboard (closed) here.

>take crowar
You can't see any such thing.

>take crowbar
Taken.

>open  Upper Cupboard
I would potentially destroy his entire cabinet, better use a smaller tool
It seems to be locked.

* * *

Coming Home
An Interactive Fiction by Geraldo
Release 1 / Serial number 210130 / Inform 7 build 6M62 (I6/v6.33 lib 6/12N) SD

Kitchen
You can see a Large Wooden Door, a Strong Metal Door, Parrot, Fridge, Lower Cupboard , Kitchen table and Upper Cupboard (closed) here.

>examine kitchen table
On Kitchen table are garage key, crowbar, pizza and mail.

>examine pizza
Pepperoni's from Joe's… That's our best pizza.

>get pizza
That would come out of my paycheck

>examine mail
Seems like some bills and a lot of ads. Why wouldn't he unsubscribe from all this mail?

>get mail
I believe that is a federal crime.

>get garage key
Taken.

* * *

Coming Home
An Interactive Fiction by Geraldo
Release 1 / Serial number 210130 / Inform 7 build 6M62 (I6/v6.33 lib 6/12N) SD

Kitchen
You can see a Large Wooden Door, a Strong Metal Door, Parrot, Fridge, Lower Cupboard , Kitchen table and Upper Cupboard (closed) here.

>examine garage
You can't see any such thing.

* * *

Coming Home
An Interactive Fiction by Geraldo
Release 1 / Serial number 210130 / Inform 7 build 6M62 (I6/v6.33 lib 6/12N) SD

Kitchen
You can see a Large Wooden Door, a Strong Metal Door, Parrot, Fridge, Lower Cupboard , Kitchen table and Upper Cupboard (closed) here.

>examine Motorcycle
This old rusty motorbike… It's a delivery one. Maybe he was a pizza guy too… back in the 1800"s HA. I've been thinking of quitting. Every other day there's a "situation" with the other pizza place. These mafias...

On Motorcycle is sticker.

>touch Motorcycle
Woah, this thing is FILTHY. Oh, there is a broken heart sticker here. He does seem like he was lonely.

I beg your pardon?

>examine sticker
I guess if I quit, I'll never see Joe's son, Ethan, again. I've had… strong feelings for him for a while now . Well, it's better this way. He would never EVER like me back. Besides, being into guys is kinda weird.

>get sticker
I'll end up ripping it apart.

* * *

Coming Home
An Interactive Fiction by Geraldo
Release 1 / Serial number 210130 / Inform 7 build 6M62 (I6/v6.33 lib 6/12N) SD

Kitchen
You can see a Large Wooden Door, a Strong Metal Door, Parrot, Fridge, Lower Cupboard , Kitchen table and Upper Cupboard (closed) here.

>examine mirror
Wow, I've really aged… And… I look so sad. But I didn't even know the guy, am I sad for him? Am I sad for his life?… I just really need to get out of here.

>get mirror
I think stealing a dead man's mirror also gives 7 years of bad luck.

>examine Bathroom Cupboard
A regular bathroom cabinet. Nothing special about its exterior.

In Bathroom Cupboard  are q-tip and tweezers.

* * *

Coming Home
An Interactive Fiction by Geraldo
Release 1 / Serial number 210130 / Inform 7 build 6M62 (I6/v6.33 lib 6/12N) SD

Kitchen
You can see a Large Wooden Door, a Strong Metal Door, Parrot, Fridge, Lower Cupboard , Kitchen table and Upper Cupboard (closed) here.

>examine Bathroom Cupboard
A regular bathroom cabinet. Nothing special about its exterior.

In Bathroom Cupboard  are q-tip, tweezers, meds and alcohol.

>examine meds
In meds is Big key.

>take Big key.
Taken.

* * *

Coming Home
An Interactive Fiction by Geraldo
Release 1 / Serial number 210130 / Inform 7 build 6M62 (I6/v6.33 lib 6/12N) SD

Kitchen
You can see a Large Wooden Door, a Strong Metal Door, Parrot, Fridge, Lower Cupboard , Kitchen table and Upper Cupboard (closed) here.

I beg your pardon?

* * *

Coming Home
An Interactive Fiction by Geraldo
Release 1 / Serial number 210130 / Inform 7 build 6M62 (I6/v6.33 lib 6/12N) SD

Kitchen
You can see a Large Wooden Door, a Strong Metal Door, Parrot, Fridge, Lower Cupboard , Kitchen table and Upper Cupboard (closed) here.

>examine Clothes rack
Looks like a work uniform. Was he still working at this age? It does not look like he worked with physics or space judging by this outfit. Guess the old man had some failed dreams… Man, am I going the sam- I should keep searching.

In Clothes rack is uniform.

>get uniform
Nothing to do with this uniform

>examine Bedside table
That is some strong booze to have sitting on the bedside table… I wonder if he... Maybe if I had gotten here sooner… No, I better not think that

On Bedside table is whiskey bottle.

>get whiskey bottle
Taken.

* * *

Coming Home
An Interactive Fiction by Geraldo
Release 1 / Serial number 210130 / Inform 7 build 6M62 (I6/v6.33 lib 6/12N) SD

Kitchen
You can see a Large Wooden Door, a Strong Metal Door, Parrot, Fridge, Lower Cupboard , Kitchen table and Upper Cupboard (closed) here.

>examine personal box
Box with a space decoration and filled with drawings, papers and toys about… space, apparently. That's pretty sweet, actually. I wonder if it belongs to a grandson (though he seems to not have any family). I always liked the idea of studying the unknown. I will study it someday actually… I think. When things are more stable, f-for sure I will… I just need more time… Err... the kid! The kid likes space. I could tell him about this box, it may distract him from the gloominess

In Personal box is secret compartment.

>open secret compartment
It seems to be locked.

>examine Clothes rack
Looks like a work uniform. Was he still working at this age? It does not look like he worked with physics or space judging by this outfit. Guess the old man had some failed dreams… Man, am I going the sam- I should keep searching.

In Clothes rack  is uniform.

>get uniform
Nothing to do with this uniform

* * *

>examine Bedside table
That is some strong booze to have sitting on the bedside table… I wonder if he... Maybe if I had gotten here sooner… No, I better not think that

On Bedside table is whiskey bottle.

>get whiskey bottle
I already spend too many nights with this scotch, maybe not this one

* * *

Coming Home
An Interactive Fiction by Geraldo
Release 1 / Serial number 210130 / Inform 7 build 6M62 (I6/v6.33 lib 6/12N) SD

Kitchen
You can see a Large Wooden Door, a Strong Metal Door, Parrot, Fridge, Lower Cupboard , Kitchen table and Upper Cupboard (closed) here.

>examine Wardrobe
Just some clothes and shoes, all very drab. That's a proper sized closet for hiding. When I was a kid, my sister and I would spend hours inside mom's closet playing with our star lantern. She used to say that was our own Milky Way… S-she must be okay, right? Yeah, she's probably okay… 

In Wardrobe is shirts.

>take shirts
I already have drab clothes of my own

* * *

Coming Home
An Interactive Fiction by Geraldo
Release 1 / Serial number 210130 / Inform 7 build 6M62 (I6/v6.33 lib 6/12N) SD

Kitchen
You can see a Large Wooden Door, a Strong Metal Door, Parrot, Fridge, Lower Cupboard , Kitchen table and Upper Cupboard (closed) here.

>set safe to 5559
You dial 5559 on the safe.

>open safe
It seems to be locked.

* * *

Coming Home
An Interactive Fiction by Geraldo
Release 1 / Serial number 210130 / Inform 7 build 6M62 (I6/v6.33 lib 6/12N) SD

Kitchen
You can see a Large Wooden Door, a Strong Metal Door, Parrot, Fridge, Lower Cupboard , Kitchen table and Upper Cupboard (closed) here.

>set safe 543
I didn't understand that sentence.

>set safe to 543
You dial 543 on the safe.

>examine safe
You have dialed the safe to 543.

>opn safe
That's not a verb I recognise.

>open safe
It seems to be locked.

* * *

Coming Home
An Interactive Fiction by Geraldo
Release 1 / Serial number 210130 / Inform 7 build 6M62 (I6/v6.33 lib 6/12N) SD

Kitchen
You can see a Large Wooden Door, a Strong Metal Door, Parrot, Fridge, Lower Cupboard , Kitchen table and Upper Cupboard (closed) here.

>set safe to 543
You dial 543 on the safe.

>open safe
You open the safe.

* * *

Coming Home
An Interactive Fiction by Geraldo
Release 1 / Serial number 210130 / Inform 7 build 6M62 (I6/v6.33 lib 6/12N) SD

Kitchen
You can see a Large Wooden Door, a Strong Metal Door, Parrot, Fridge, Lower Cupboard , Kitchen table and Upper Cupboard (closed) here.

>set safe to 111
You dial 111 on the safe.

>open safe
You open the safe.

* * *

Coming Home
An Interactive Fiction by Geraldo
Release 1 / Serial number 210130 / Inform 7 build 6M62 (I6/v6.33 lib 6/12N) SD

Kitchen
You can see a Large Wooden Door, a Strong Metal Door, Parrot, Fridge, Lower Cupboard , Kitchen table and Upper Cupboard (closed) here.

>examine safe
There is a phone ringing inside that safe. I need a 4 character password to open it.

>spin safe 4321
That's not a verb I recognise.

* * *

>examine safe
There is a phone ringing inside that safe. I need a 4 character password to open it.

>SS59
**BUZZ**  Yeah I got it. thank you dear parrot. Now what is in this safe.

>SS59
That's not a verb I recognise.

Safe Message: Please enter the password now.

* * *

>SS59
**BUZZ**  Yeah I got it. thank you dear parrot. Now what is in this safe.

>examine safe
There is a phone ringing inside that safe. I need a 4 character password to open it.

Please enter the password now.

>open safe
Incorrect password.

Would you like to try again? (Yes or No)

* * *

>open safe
You open safe, revealing a phone and photos.

* * *

>examine safe
There is a phone ringing inside that safe. I need a 4 character password to open it.

>hrllo
That's not a verb I recognise.

Safe Message: Please enter the password now.

* * *

>examine safe
There is a phone ringing inside that safe. I need a 4 character password to open it.

>lele
Incorrect password.

Should i try again?

>n
You can't go that way.

Would you like to try again? (Yes or No)

>No
That was a rhetorical question.

Would you like to try again? (Yes or No)

>No
That was a rhetorical question.

Would you like to try again? (Yes or No)

>Y
That was a rhetorical question.

Would you like to try again? (Yes or No)

* * *

>lele
Incorrect password.

Should i try again?

>No
That was a rhetorical question.

Should i try again?

>No
That was a rhetorical question.

Should i try again?

>Yes
That was a rhetorical question.

Should i try again?

* * *

>lele
Incorrect password.

Should i try again?

>try
Should i try again?

>try
Should i try again?

>y
Please enter the password now.

>lolo
Incorrect password.

Should i try again?

>try again
Please enter the password now.

* * *

>examine safe
There is a phone ringing inside that safe. I need a 4 character password to open it.

>open safe
It seems to be locked.

>unlock safe
What do you want to unlock safe with?

>password
You can't see any such thing.

* * *

Coming Home
An Interactive Fiction by Geraldo
Release 1 / Serial number 210130 / Inform 7 build 6M62 (I6/v6.33 lib 6/12N) SD

Kitchen
You can see a Large Wooden Door, a Strong Metal Door, Parrot, Fridge, Lower Cupboard , Kitchen table and Upper Cupboard (closed) here.

>The Safe is here. "A mammoth safe, with a dial which can spin to any number, has pride of place. It must weigh about the same as a small car, so don't get any ideas." Instead of opening the safe, say "The safe opens only when turned to the correct combination."
You seem to want to talk to someone, but I can't see whom.

>open safe
You can't see any such thing.

* * *

Coming Home
An Interactive Fiction by Geraldo
Release 1 / Serial number 210130 / Inform 7 build 6M62 (I6/v6.33 lib 6/12N) SD

Kitchen
You can see a Large Wooden Door, a Strong Metal Door, Parrot, Fridge, Lower Cupboard , Kitchen table and Upper Cupboard (closed) here.

>open safe
The safe opens only when turned to the correct combination.

>open safe
The safe opens only when turned to the correct combination.

>spin safe to 1222
Click! and nothing else happens.

* * *

>open safe
The safe opens only when turned to the correct combination.

>examine safe
A mammoth safe, with a dial which can spin to any number, has pride of place. It must weigh about the same as a small car, so don't get any ideas.

* * *

Coming Home
An Interactive Fiction by Geraldo
Release 1 / Serial number 210130 / Inform 7 build 6M62 (I6/v6.33 lib 6/12N) SD

Kitchen
You can see a Large Wooden Door, a Strong Metal Door, Parrot, Fridge, Lower Cupboard , Kitchen table and Upper Cupboard (closed) here.

>spin safe to 1384
Clonk! and the safe door swings slowly open, revealing a phone.

>take phone
Taken.

* * *

Coming Home
An Interactive Fiction by Geraldo
Release 1 / Serial number 210130 / Inform 7 build 6M62 (I6/v6.33 lib 6/12N) SD

Kitchen
You can see a Large Wooden Door, a Strong Metal Door, Parrot, Fridge, Lower Cupboard , Kitchen table and Upper Cupboard (closed) here.

>set safe to 1384
No, you can't set that to anything.

>spin safe to 1384
Clonk! and the safe door swings slowly open, revealing a phone and photos.

* * *

Coming Home
An Interactive Fiction by Geraldo
Release 1 / Serial number 210130 / Inform 7 build 6M62 (I6/v6.33 lib 6/12N) SD

Kitchen
You can see a Large Wooden Door, a Strong Metal Door, Parrot, Fridge, Lower Cupboard , Kitchen table and Upper Cupboard (closed) here.

>ash child
That's not a verb I recognise.

>ask child about
What do you want to ask Child about?

>the corpse
There is no reply.

* * *

Coming Home
An Interactive Fiction by Geraldo
Release 1 / Serial number 210130 / Inform 7 build 6M62 (I6/v6.33 lib 6/12N) SD

Kitchen
You can see a Large Wooden Door, a Strong Metal Door, Parrot, Fridge, Lower Cupboard , Kitchen table and Upper Cupboard (closed) here.

>ask child about love
There is no reply.

>ask child
What do you want to ask Child for?

>love
You can't see any such thing.

>ask child about
What do you want to ask Child about?

>safe
There is no reply.

>ask child about
What do you want to ask Child about?

>trophies
Child does not spin.

* * *

Coming Home
An Interactive Fiction by Geraldo
Release 1 / Serial number 210130 / Inform 7 build 6M62 (I6/v6.33 lib 6/12N) SD

Kitchen
You can see a Large Wooden Door, a Strong Metal Door, Parrot, Fridge, Lower Cupboard , Kitchen table and Upper Cupboard (closed) here.

>ask child about
Child does not spin.

* * *

Coming Home
An Interactive Fiction by Geraldo
Release 1 / Serial number 210130 / Inform 7 build 6M62 (I6/v6.33 lib 6/12N) SD

Kitchen
You can see a Large Wooden Door, a Strong Metal Door, Parrot, Fridge, Lower Cupboard , Kitchen table and Upper Cupboard (closed) here.

>ask child about games
"I don't like games," she sniffs.

>ask child about checkers
"I don't like games," she sniffs.

* * *

Coming Home
An Interactive Fiction by Geraldo
Release 1 / Serial number 210130 / Inform 7 build 6M62 (I6/v6.33 lib 6/12N) SD

Kitchen
You can see a Large Wooden Door, a Strong Metal Door, Parrot, Fridge, Lower Cupboard , Kitchen table and Upper Cupboard (closed) here.

>ask child about corpse
He looks familiar, but I don't know him. I just woke up in this house alone. Will someone hurt us?

>talk to child
That's not a verb I recognise.

* * *

Coming Home
An Interactive Fiction by Geraldo
Release 1 / Serial number 210130 / Inform 7 build 6M62 (I6/v6.33 lib 6/12N) SD

Kitchen
You can see a Large Wooden Door, a Strong Metal Door, Parrot, Fridge, Lower Cupboard , Kitchen table and Upper Cupboard (closed) here.

>ask child about space
I COULD TALK ABOUT IT FOR DAYS. Last week I won a school contest just talking about the Milky Way for 100 people! My sister helped me with the slides. She made 10 star lanterns to light the room. Ten!

>ask child about parrot
I like the parrot, he seems sad about the grandpa. Maybe we should give him a pet to cheer him up

* * *

>ask child about space
I COULD TALK ABOUT IT FOR DAYS. Last week I won a school contest just talking about the Milky Way for 100 people! My sister helped me with the slides. She made 10 star lanterns to light the room. Ten!

>ask child about password
I have no idea

* * *

Coming Home
An Interactive Fiction by Geraldo
Release 1 / Serial number 210130 / Inform 7 build 6M62 (I6/v6.33 lib 6/12N) SD

Kitchen
You can see a Large Wooden Door, a Strong Metal Door, Parrot, Fridge, Lower Cupboard , Kitchen table and Upper Cupboard (closed) here.

>tell child hi
Are you ok? It's ok, I'm not gonna harm you

>tell child sorry
There is no reply.

* * *

Coming Home
An Interactive Fiction by Geraldo
Release 1 / Serial number 210130 / Inform 7 build 6M62 (I6/v6.33 lib 6/12N) SD

Kitchen
You can see a Large Wooden Door, a Strong Metal Door, Parrot, Fridge, Lower Cupboard , Kitchen table and Upper Cupboard (closed) here.

>tell chid yes
You can't see any such thing.

>tell child yes
That was a rhetorical question.

>say child yes
(to Child)
There is no reply.

>say yes to child
That was a rhetorical question.

* * *

Coming Home
An Interactive Fiction by Geraldo
Release 1 / Serial number 210130 / Inform 7 build 6M62 (I6/v6.33 lib 6/12N) SD

Kitchen
You can see a Large Wooden Door, a Strong Metal Door, Parrot, Fridge, Lower Cupboard , Kitchen table and Upper Cupboard (closed) here.

>yes
She looks interested.

* * *

Coming Home
An Interactive Fiction by Geraldo
Release 1 / Serial number 210130 / Inform 7 build 6M62 (I6/v6.33 lib 6/12N) SD

Kitchen
You can see a Large Wooden Door, a Strong Metal Door, Parrot, Fridge, Lower Cupboard , Kitchen table and Upper Cupboard (closed) here.

>say yes to sybil
She looks interested.

* * *

Coming Home
An Interactive Fiction by Geraldo
Release 1 / Serial number 210130 / Inform 7 build 6M62 (I6/v6.33 lib 6/12N) SD

Kitchen
You can see a Large Wooden Door, a Strong Metal Door, Parrot, Fridge, Lower Cupboard , Kitchen table and Upper Cupboard (closed) here.

>no
Are you ok? It's ok, I'm not gonna harm you

* * *

Coming Home
An Interactive Fiction by Geraldo
Release 1 / Serial number 210130 / Inform 7 build 6M62 (I6/v6.33 lib 6/12N) SD

Kitchen
You can see a Large Wooden Door, a Strong Metal Door, Parrot, Fridge, Lower Cupboard , Kitchen table and Upper Cupboard (closed) here.

>sorry
She looks bored.

* * *

Coming Home
An Interactive Fiction by Geraldo
Release 1 / Serial number 210130 / Inform 7 build 6M62 (I6/v6.33 lib 6/12N) SD

Kitchen
You can see a Large Wooden Door, a Strong Metal Door, Parrot, Fridge, Lower Cupboard , Kitchen table and Upper Cupboard (closed) here.

>ask sybil about her
Her smile unnerves you.

* * *

Coming Home
An Interactive Fiction by Geraldo
Release 1 / Serial number 210130 / Inform 7 build 6M62 (I6/v6.33 lib 6/12N) SD

Kitchen
You can see a Large Wooden Door, a Strong Metal Door, Parrot, Fridge, Lower Cupboard , Kitchen table and Upper Cupboard (closed) here.

>ash child about him
That's not a verb I recognise.

>ask child about him
There is no reply.

* * *

Coming Home
An Interactive Fiction by Geraldo
Release 1 / Serial number 210130 / Inform 7 build 6M62 (I6/v6.33 lib 6/12N) SD

Kitchen
You can see a Large Wooden Door, a Strong Metal Door, Parrot, Fridge, Lower Cupboard , Kitchen table and Upper Cupboard (closed) here.

>ask child about him
Are you ok? It's ok, I'm not gonna harm you

* * *

Coming Home
An Interactive Fiction by Geraldo
Release 1 / Serial number 210130 / Inform 7 build 6M62 (I6/v6.33 lib 6/12N) SD

Kitchen
You can see a Large Wooden Door, a Strong Metal Door, Parrot, Fridge, Lower Cupboard , Kitchen table and Upper Cupboard (closed) here.

>ask child about name
I-I don't remember...
That is one spirited kid… So many hopes and dreams. I miss this feeling. Hope.

* * *

Coming Home
An Interactive Fiction by Geraldo
Release 1 / Serial number 210130 / Inform 7 build 6M62 (I6/v6.33 lib 6/12N) SD

Kitchen
You can see a Large Wooden Door, a Strong Metal Door, Parrot, Fridge, Lower Cupboard , Kitchen table and Upper Cupboard (closed) here.

>ask child about hox
There is no reply.

>ask child about private box
Child: WOW this box is amazing. I always loved the space. My room has all these stars in the ceiling, and my mom tells me I am going to be an astronaut someday! I hope she is right. I wanna make her proud. Hey, I just thought: maybe the box has a secret compartment! That's how I hide stuff from my sister in my room. I love her, but she is really nosy That is one spirited kid… So many hopes and dreams. I miss this feeling. Hope.

* * *

Coming Home
An Interactive Fiction by Geraldo
Release 1 / Serial number 210130 / Inform 7 build 6M62 (I6/v6.33 lib 6/12N) SD

Kitchen
You can see a Large Wooden Door, a Strong Metal Door, Parrot, Fridge, Lower Cupboard , Kitchen table and Upper Cupboard (closed) here.

>ask child about private
There is no reply.

>ask child about private box
Child: WOW this box is amazing. I always loved the space. My room has all these stars in the ceiling, and my mom tells me I am going to be an astronaut someday! I hope she is right. I wanna make her proud. Hey, I just thought: maybe the box has a secret compartment! That's how I hide stuff from my sister in my room. I love her, but she is really nosyThat is one spirited kid… So many hopes and dreams. I miss this feeling. Hope.

* * *

Coming Home
An Interactive Fiction by Geraldo
Release 1 / Serial number 210130 / Inform 7 build 6M62 (I6/v6.33 lib 6/12N) SD

Kitchen
You can see a Large Wooden Door, a Strong Metal Door, Parrot, Fridge, Lower Cupboard , Kitchen table and Upper Cupboard (closed) here.

>ask child about private box
Child: WOW this box is amazing. I always loved the space. My room has all these stars in the ceiling, and my mom tells me I am going to be an astronaut someday! I hope she is right. I wanna make her proud. Hey, I just thought: maybe the box has a secret compartment! That's how I hide stuff from my sister in my room. I love her, but she is really nosy
 
 That is one spirited kid… So many hopes and dreams. I miss this feeling. Hope.

* * *

Coming Home
An Interactive Fiction by Geraldo
Release 1 / Serial number 210130 / Inform 7 build 6M62 (I6/v6.33 lib 6/12N) SD

Kitchen
You can see a Large Wooden Door, a Strong Metal Door, Parrot, Fridge, Lower Cupboard , Kitchen table and Upper Cupboard (closed) here.

>pet parrot
Ouch. You bite me. Hey, that's nasty
 
 Parrot: Nasty Nasty

* * *

Coming Home
An Interactive Fiction by Geraldo
Release 1 / Serial number 210130 / Inform 7 build 6M62 (I6/v6.33 lib 6/12N) SD

Kitchen
You can see a Large Wooden Door, a Strong Metal Door, Parrot, Fridge, Lower Cupboard , Kitchen table and Upper Cupboard (closed) here.

>unlocking Upper Cupboard with crowbar
That's not a verb I recognise.

>unlock Upper Cupboard with crowbar
(first taking crowbar)
oi

* * *

Coming Home
An Interactive Fiction by Geraldo
Release 1 / Serial number 210130 / Inform 7 build 6M62 (I6/v6.33 lib 6/12N) SD

Kitchen
You can see a Large Wooden Door, a Strong Metal Door, Parrot, Fridge, Lower Cupboard , Kitchen table and Upper Cupboard (closed) here.

>unlock Upper Cupboard  with crowbar
(first taking crowbar)
That doesn't seem to fit the lock.

* * *

Coming Home
An Interactive Fiction by Geraldo
Release 1 / Serial number 210130 / Inform 7 build 6M62 (I6/v6.33 lib 6/12N) SD

Kitchen
You can see a Large Wooden Door, a Strong Metal Door, Parrot, Fridge, Lower Cupboard , Kitchen table and Upper Cupboard (closed) here.

>Large Wooden Door
That's not a verb I recognise.

I beg your pardon?

>unlock Large Wooden Door
What do you want to unlock the Large Wooden Door with?

>crowbar
(first taking crowbar)
That doesn't seem to fit the lock.

>unlock Large Wooden Door with crowbar
That doesn't seem to fit the lock.

* * *

Coming Home
An Interactive Fiction by Geraldo
Release 1 / Serial number 210130 / Inform 7 build 6M62 (I6/v6.33 lib 6/12N) SD

Kitchen
You can see a Large Wooden Door, a Strong Metal Door, Parrot, Fridge, Lower Cupboard , Kitchen table and Upper Cupboard (closed) here.

>unlock Large Wooden Door with crowbar
(first taking crowbar)
That doesn't seem to fit the lock.

* * *

Coming Home
An Interactive Fiction by Geraldo
Release 1 / Serial number 210130 / Inform 7 build 6M62 (I6/v6.33 lib 6/12N) SD

Kitchen
You can see a Large Wooden Door, a Strong Metal Door, Parrot, Fridge, Lower Cupboard , Kitchen table and Upper Cupboard (closed) here.

>unlock Large Wooden Door with crowar
You can't see any such thing.

>unlock Large Wooden Door with crowbar
(first taking crowbar)
That doesn't seem to fit the lock.

* * *

Coming Home
An Interactive Fiction by Geraldo
Release 1 / Serial number 210130 / Inform 7 build 6M62 (I6/v6.33 lib 6/12N) SD

Kitchen
You can see a Large Wooden Door, a Strong Metal Door, Parrot, Fridge, Lower Cupboard , Kitchen table and Upper Cupboard (closed) here.

>unlocking Upper Cupboard
That's not a verb I recognise.

>unlock Upper Cupboard
You're not going that way.

>take garage key
Taken.

>unlock Upper Cupboard
You're not going that way.

* * *

Coming Home
An Interactive Fiction by Geraldo
Release 1 / Serial number 210130 / Inform 7 build 6M62 (I6/v6.33 lib 6/12N) SD

Kitchen
You can see a Large Wooden Door, a Strong Metal Door, Parrot, Fridge, Lower Cupboard , Kitchen table and Upper Cupboard (closed) here.

>unlock [something]
You can't see any such thing.

>unlock  Upper Cupboard
What do you want to unlock Upper Cupboard with?

>crowbar
(first taking crowbar)
You're not going that way.

>take garage key
Taken.

>unlock Upper Cupboard
What do you want to unlock Upper Cupboard with?

>garage key
That doesn't seem to fit the lock.

* * *

Coming Home
An Interactive Fiction by Geraldo
Release 1 / Serial number 210130 / Inform 7 build 6M62 (I6/v6.33 lib 6/12N) SD

Kitchen
You can see a Large Wooden Door, a Strong Metal Door, Parrot, Fridge, Lower Cupboard , Kitchen table and Upper Cupboard (closed) here.

>take screwdriver
Taken.

>take crowbar
Taken.

>unlock Upper Cupboard
What do you want to unlock Upper Cupboard with?

>screwdriver
You unlock Upper Cupboard.

* * *

>unlock Upper Cupboard with crowbar
(first taking crowbar)
I would potentially destroy his entire cabinet, better use a smaller tool

* * *

>unlock Upper Cupboard with crowbar
I would potentially destroy his entire cabinet, better use a smaller tool

I beg your pardon?

* * *

Coming Home
An Interactive Fiction by Geraldo
Release 1 / Serial number 210130 / Inform 7 build 6M62 (I6/v6.33 lib 6/12N) SD

Kitchen
You can see a Large Wooden Door, a Strong Metal Door, Parrot, Fridge, Lower Cupboard , Kitchen table and Upper Cupboard (closed) here.

>olar  Large Wooden Door
What do you want to olar the Large Wooden Door with?

* * *

Coming Home
An Interactive Fiction by Geraldo
Release 1 / Serial number 210130 / Inform 7 build 6M62 (I6/v6.33 lib 6/12N) SD

Kitchen
You can see a Large Wooden Door, a Strong Metal Door, Parrot, Fridge, Lower Cupboard , Kitchen table and Upper Cupboard (closed) here.

>go to dinner
You can't see any such thing.

* * *

Coming Home
An Interactive Fiction by Geraldo
Release 1 / Serial number 210130 / Inform 7 build 6M62 (I6/v6.33 lib 6/12N) SD

Kitchen
You can see a Large Wooden Door, a Strong Metal Door, Parrot, Fridge, Lower Cupboard , Kitchen table and Upper Cupboard (closed) here.

>examine security terminal
You see nothing special about security terminal.

Please enter the password now.

>giggity
**BUZZ**  You have unlocked the security door.

* * *

>examine security terminal
You see nothing special about security terminal.

Please enter the password now.

>SS59
**BUZZ**  You have unlocked the security door.

* * *

Coming Home
An Interactive Fiction by Geraldo
Release 1 / Serial number 210130 / Inform 7 build 6M62 (I6/v6.33 lib 6/12N) SD

Kitchen
You can see a Large Wooden Door, a Strong Metal Door, Parrot, Fridge, Lower Cupboard , Kitchen table and Upper Cupboard (closed) here.

>unlock safe
Enter the password now.

>unlock safe
You must supply a noun.

* * *

>unlock safe
Enter the password now.

>unlock safe with door
(first taking the Old Blue Door)
That's fixed in place.

* * *

>unlock safe
Enter the password now.

>SS59
**BUZZ**  Yeah I got it. thank you dear parrot. Now what is in this safe.

>HJJH
That's not a verb I recognise.

"Enter the password now."

* * *

Coming Home
An Interactive Fiction by Geraldo
Release 1 / Serial number 210130 / Inform 7 build 6M62 (I6/v6.33 lib 6/12N) SD

Kitchen
You can see a Large Wooden Door, a Strong Metal Door, Parrot, Fridge, Lower Cupboard , Kitchen table and Upper Cupboard (closed) here.

>try to open the
What do you want to try to open?

>safe
You must supply a second noun.

* * *

Coming Home
An Interactive Fiction by Geraldo
Release 1 / Serial number 210130 / Inform 7 build 6M62 (I6/v6.33 lib 6/12N) SD

Kitchen
You can see a Large Wooden Door, a Strong Metal Door, Parrot, Fridge, Lower Cupboard , Kitchen table and Upper Cupboard (closed) here.

>try to open the safe
"Enter the password now."

>SSF5
Incorrect password.

Should i try again?

>SS59
Should i try again?

>yes
Please enter the password now.

>SS59
**BUZZ**  Yeah I got it. thank you dear parrot. Now what is in this safe.

>open safe
You open safe, revealing a phone and photos.

* * *

Coming Home
An Interactive Fiction by Geraldo
Release 1 / Serial number 210130 / Inform 7 build 6M62 (I6/v6.33 lib 6/12N) SD

Kitchen
You can see a Large Wooden Door, a Strong Metal Door, Parrot, Fridge, Lower Cupboard , Kitchen table and Upper Cupboard (closed) here.

>try to unlock safe
Enter the password now.

>ss59
**BUZZ**  Yeah I got it. thank you dear parrot. Now what is in this safe.

>open safe
You open safe, revealing a phone and photos.

* * *

>try to unlock safe
Enter the password now.

>SS59
**BUZZ**  Yeah I got it. thank you dear parrot. Now what is in this safe.

* * *

Coming Home
An Interactive Fiction by Geraldo
Release 1 / Serial number 210130 / Inform 7 build 6M62 (I6/v6.33 lib 6/12N) SD

Kitchen
You can see a Large Wooden Door, a Strong Metal Door, Parrot, Fridge, Lower Cupboard , Kitchen table and Upper Cupboard (closed) here.

>try open the safe
I didn't understand that sentence.

>try to open the safe
Please enter the password now.

* * *

Coming Home
An Interactive Fiction by Geraldo
Release 1 / Serial number 210130 / Inform 7 build 6M62 (I6/v6.33 lib 6/12N) SD

Kitchen
You can see a Large Wooden Door, a Strong Metal Door, Parrot, Fridge, Lower Cupboard , Kitchen table and Upper Cupboard (closed) here.

>try oopen safe
I didn't understand that sentence.

>try open safe
"Enter the password now."

>SS59
That's not a verb I recognise.

"Enter the password now."

>NO
That was a rhetorical question.

"Enter the password now."

* * *

Coming Home
An Interactive Fiction by Geraldo
Release 1 / Serial number 210130 / Inform 7 build 6M62 (I6/v6.33 lib 6/12N) SD

Kitchen
You can see a Large Wooden Door, a Strong Metal Door, Parrot, Fridge, Lower Cupboard , Kitchen table and Upper Cupboard (closed) here.

>try to open safe
Please enter the password now.

>SS59
**BUZZ**  Yeah I got it. thank you dear parrot. Now what is in this safe.